जिल्ला,स्थानीय तह,जम्मा परिवार संख्या,जम्मा जनगणना घर संख्या,जम्मा जनसंख्या,जम्मा पुरुष,जम्मा महिला
ताप्लेजुङ,आठराई त्रिवेणी गाउँपालिका,2869,2735,12288,6005,6283
ताप्लेजुङ,मैवाखोला गाउँपालिका,2275,2178,10365,5264,5101
ताप्लेजुङ,मेरिङदेन गाउँपालिका,2683,2528,12040,6181,5859
ताप्लेजुङ,मिक्वाखोला गाउँपालिका,1862,1792,7991,4000,3991
ताप्लेजुङ,फक्ताङलुङ गाउँपालिका,2864,2700,11925,6239,5686
ताप्लेजुङ,फुङलिङ नगरपालिका,7306,5888,28786,14160,14626
ताप्लेजुङ,सिदिङ्वा गाउँपालिका,2604,2484,10981,5593,5388
ताप्लेजुङ,सिरीजङ्घा  गाउँपालिका,3329,3197,14186,7227,6959
ताप्लेजुङ,पाथीभरा याङवरक गाउँपालिका,2738,2637,11797,5855,5942
पाँचथर,फालेलुङ गाउँपालिका,4940,4773,20531,10211,10320
पाँचथर,फाल्गुनन्द गाउँपालिका,5293,4968,21253,10417,10836
पाँचथर,हिलिहाङ गाउँपालिका,4878,4647,20537,10160,10377
पाँचथर,कुम्मायक गाउँपालिका,3199,3012,13020,6532,6488
पाँचथर,मिक्लाजुङ गाउँपालिका,5509,5163,21328,10535,10793
पाँचथर,फिदिम नगरपालिका,12433,10442,48713,23963,24750
पाँचथर,तुम्वेवा गाउँपालिका,2752,2636,11063,5644,5419
पाँचथर,याङवरक गाउँपालिका,3964,3765,16828,8509,8319
इलाम ,चुलाचुली गाउँपालिका,5624,5533,22856,11215,11641
इलाम ,देउमाई नगरपालिका,7907,7535,31531,15807,15724
इलाम ,फाकफोकथुम गाउँपालिका,4923,4748,20004,9800,10204
इलाम ,ईलाम नगरपालिका,13395,11943,50455,24781,25674
इलाम ,माईजोगमाई गाउँपालिका,4957,4881,19295,9686,9609
इलाम ,माई नगरपालिका,7966,7844,30988,15126,15862
इलाम ,माङसेबुङ गाउँपालिका,3891,3793,16897,8602,8295
इलाम ,रोङ गाउँपालिका,4715,4650,17555,8739,8816
इलाम ,सन्दकपुर गाउँपालिका,4031,3937,15460,7840,7620
इलाम ,सूर्योदय नगरपालिका,14149,13463,55457,27922,27535
झापा ,अर्जुनधारा नगरपालिका,20978,18995,84429,40591,43838
झापा ,बाह्रदशी गाउँपालिका,9053,8665,37916,17952,19964
झापा ,भद्रपुर नगरपालिका,17385,16032,70823,33988,36835
झापा ,बिर्तामोड नगरपालिका,29861,23039,117355,57136,60219
झापा ,बुद्धशान्ति गाउँपालिका,13276,12518,52911,25276,27635
झापा ,दमक नगरपालिका,27725,22000,107410,51118,56292
झापा ,गौरादह नगरपालिका,14845,14137,60598,28782,31816
झापा ,गौरिगञ्ज गाउँपालिका,8712,8069,36058,17089,18969
झापा ,हल्दीबारी गाउँपालिका,7894,7621,33054,15831,17223
झापा ,झापा गाउँपालिका,8554,8003,39372,19131,20241
झापा ,कचनकवल गाउँपालिका,10200,9260,42386,20024,22362
झापा ,कमल गाउँपालिका,13356,12335,53710,25739,27971
झापा ,कन्काई नगरपालिका,13553,12419,53088,25557,27531
झापा ,मेचीनगर नगरपालिका,32710,29865,131520,64410,67110
झापा ,शिवसताक्षी नगरपालिका,18036,17031,73460,34872,38588
मोरङ,बेलवारी नगरपालिका,20662,18945,81837,38460,43377
मोरङ,विराटनगर महानगरपालिका,57383,45204,244750,122769,121981
मोरङ,बुढीगंगा गाउँपालिका,12455,10768,51640,25472,26168
मोरङ,धनपालथान गाउँपालिका,9935,8528,45204,22136,23068
मोरङ,ग्रामथान गाउँपालिका,9483,8660,36500,17889,18611
मोरङ,जहदा गाउँपालिका,9868,8489,47836,24262,23574
मोरङ,कानेपोखरी गाउँपालिका,10760,10271,43177,20441,22736
मोरङ,कटहरी गाउँपालिका,10522,9370,48633,24414,24219
मोरङ,केराबारी गाउँपालिका,8809,8184,34725,16768,17957
मोरङ,लेटाङ नगरपालिका,9304,8758,38675,18473,20202
मोरङ,मिक्लाजुङ गाउँपालिका,8390,7969,33315,16074,17241
मोरङ,पथरी शनिश्चरे नगरपालिका,18191,16621,72689,34263,38426
मोरङ,रंगेली नगरपालिका,13339,11903,57814,28238,29576
मोरङ,रतुवामाई नगरपालिका,14624,13768,61355,29091,32264
मोरङ,सुन्दरहरैंचा नगरपालिका,30219,26677,121305,57858,63447
मोरङ,सुनवर्षी नगरपालिका,12889,11401,56169,27092,29077
मोरङ,उर्लाबारी नगरपालिका,17818,15899,71562,33827,37735
सुनसरी,वराहक्षेत्र नगरपालिका,21961,20781,91891,43178,48713
सुनसरी,बर्जु गाउँपालिका,8034,6867,36533,18571,17962
सुनसरी,भोक्राहा नरसिंह गाउँपालिका,9299,8155,49371,24501,24870
सुनसरी,देवानगञ्ज गाउँपालिका,7814,6526,39367,19710,19657
सुनसरी,धरान उपमहानगरपालिका,43815,34834,173096,82683,90413
सुनसरी,दुहवी नगरपालिका,15415,12410,67051,33448,33603
सुनसरी,गढी गाउँपालिका,8751,7664,39478,19426,20052
सुनसरी,हरिनगर गाउँपालिका,8765,7630,49501,24459,25042
सुनसरी,इनरुवा नगरपालिका,16931,15044,75920,37273,38647
सुनसरी,ईटहरी उपमहानगरपालिका,50743,40207,198098,94308,103790
सुनसरी,कोशी गाउँपालिका,9377,7634,48768,24550,24218
सुनसरी,रामधुनी नगरपालिका,15969,14025,63378,29980,33398
धनकुटा,चौबिसे गाउँपालिका,4493,4233,17914,8764,9150
धनकुटा,छथर जोरपाटी गाउँपालिका,4143,3932,16477,7976,8501
धनकुटा,धनकुटा नगरपालिका,9803,8087,36156,17387,18769
धनकुटा,सहिदभूमि गाउँपालिका,4109,4079,17784,8807,8977
धनकुटा,महालक्ष्मी नगरपालिका,5434,5251,22196,10862,11334
धनकुटा,पाख्रिवास नगरपालिका,4881,4644,19256,9247,10009
धनकुटा,साँगुरीगढी गाउँपालिका,5025,4860,19601,9626,9975
तेह्रथुम,आठराई गाउँपालिका,4427,4223,18210,8996,9214
तेह्रथुम,छथर गाउँपालिका,3509,3390,14245,6960,7285
तेह्रथुम,लालीगुराँस नगरपालिका,3773,3439,15418,7482,7936
तेह्रथुम,मेन्छयायेम गाउँपालिका,1708,1620,6698,3272,3426
तेह्रथुम,म्याङलुङ नगरपालिका,4934,4163,19078,9347,9731
तेह्रथुम,फेदाप गाउँपालिका,3671,3517,15236,7506,7730
संखुवासभा,भोटखोला गाउँपालिका,1717,1677,6509,3256,3253
संखुवासभा,चैनपुर नगरपालिका,6690,6201,27078,13210,13868
संखुवासभा,चिचिला गाउँपालिका,1672,1583,6720,3351,3369
संखुवासभा,धर्मदेवी नगरपालिका,4071,3906,16300,7890,8410
संखुवासभा,खाँदवारी नगरपालिका,9333,8151,36102,17967,18135
संखुवासभा,मादी नगरपालिका,3288,3169,13428,6584,6844
संखुवासभा,मकालु गाउँपालिका,3485,3309,13492,6920,6572
संखुवासभा,पाँचखपन नगरपालिका,4010,3897,16391,8060,8331
संखुवासभा,सभापोखरी गाउँपालिका,2533,2362,10005,5012,4993
संखुवासभा,सिलीचोङ गाउँपालिका,2501,2427,10432,5223,5209
भोजपुर,आमचोक गाउँपालिका,3566,3472,15237,7517,7720
भोजपुर,अरुण गाउँपालिका,3582,3487,14853,7247,7606
भोजपुर,भोजपुर नगरपालिका,6775,6078,26126,12676,13450
भोजपुर,हतुवागढी गाउँपालिका,4040,3987,16302,8030,8272
भोजपुर,पौवादुङ्मा गाउँपालिका,2933,2866,12170,5851,6319
भोजपुर,रामप्रसादराई गाउँपालिका,3700,3627,15632,7741,7891
भोजपुर,साल्पासिलिछो गाउँपालिका,3019,2972,12229,6008,6221
भोजपुर,षडानन्द नगरपालिका,7450,7139,29777,14681,15096
भोजपुर,टेम्केमैयुङ गाउँपालिका,3855,3773,15491,7611,7880
सोलुखुम्बु,थुलुङ दुधकोशी गाउँपालिका,4672,4568,18459,9225,9234
सोलुखुम्बु,माप्य दुधकोशी गाउँपालिका,3142,3102,12746,6422,6324
सोलुखुम्बु,खुम्बु पासाङल्हामु गाउँपालिका,2611,2341,9226,4737,4489
सोलुखुम्बु,लिखु पिके गाउँपालिका,1255,1255,5264,2588,2676
सोलुखुम्बु,माहाकुलुङ गाउँपालिका,2909,2885,11971,5921,6050
सोलुखुम्बु,नेचासल्यान गाउँपालिका,2662,2631,10828,5325,5503
सोलुखुम्बु,सोलुदुधकुण्ड नगरपालिका,6830,6335,27013,13700,13313
सोलुखुम्बु,सोताङ गाउँपालिका,2321,2271,9261,4711,4550
ओखलढुङ्गा,चम्पादेवी गाउँपालिका,4040,3977,16528,8146,8382
ओखलढुङ्गा,चिशंखुगढी गाउँपालिका,3346,3321,13761,6711,7050
ओखलढुङ्गा,खिजिदेम्वा गाउँपालिका,3496,3461,15867,7926,7941
ओखलढुङ्गा,लिखु गाउँपालिका ,3189,3125,11930,5912,6018
ओखलढुङ्गा,मानेभन्ज्याङ गाउँपालिका,4855,4795,19883,9626,10257
ओखलढुङ्गा,मोलुङ गाउँपालिका,4173,4116,16944,8464,8480
ओखलढुङ्गा,सिद्धिचरण नगरपालिका,7173,6957,27977,13554,14423
ओखलढुङ्गा,सुनकोशी गाउँपालिका ,4417,4359,18024,8983,9041
खोटाङ,ऐसेलुखर्क गाउँपालिका,3506,3421,13581,6713,6868
खोटाङ,बराहपोखरी गाउँपालिका,2591,2540,11461,5713,5748
खोटाङ,दिप्रुङ चुइचुम्मा गाउँपालिका,3848,3780,16549,8139,8410
खोटाङ,हलेसी तुवाचुङ नगरपालिका,6149,5948,27274,13434,13840
खोटाङ,जन्तेढुङ्गा गाउँपालिका,2765,2713,12066,5934,6132
खोटाङ,केपिलासगढी गाउँपालिका,3346,3237,13339,6583,6756
खोटाङ,खोटेहाङ गाउँपालिका,4149,4056,16952,8417,8535
खोटाङ,रावा बेसी गाउँपालिका,2724,2646,11218,5424,5794
खोटाङ,दिक्तेल रुपाकोट मझुवागढी नगरपालिका,10719,9775,43295,21345,21950
खोटाङ,साकेला गाउँपालिका,2307,2276,9605,4819,4786
उदयपुर,वेलका नगरपालिका,12170,11633,51458,24631,26827
उदयपुर,चौदण्डीगढी नगरपालिका,12857,12162,53537,25389,28148
उदयपुर,कटारी नगरपालिका,14296,12843,60168,29250,30918
उदयपुर,रौतामाई गाउँपालिका,4586,4434,20418,10017,10401
उदयपुर,लिम्चुङबुङ गाउँपालिका,2257,2229,9789,4837,4952
उदयपुर,ताप्ली गाउँपालिका,2884,2843,13377,6648,6729
उदयपुर,त्रियुगा नगरपालिका,25928,23138,104375,49514,54861
उदयपुर,उदयपुरगढी गाउँपालिका,6810,6650,28929,14093,14836
सप्तरी,अग्निसाइर कृष्णसवरन गाउँपालिका,6726,6092,32047,15735,16312
सप्तरी,बलान बिहुल गाउँपालिका,5004,3770,24059,12169,11890
सप्तरी,राजगढ गाउँपालिका,6942,5687,32975,16564,16411
सप्तरी,बिष्णुपुर गाउँपालिका,5780,5007,28072,14230,13842
सप्तरी,बोदेबरसाईन नगरपालिका,9854,7988,46343,23092,23251
सप्तरी,छिन्नमस्ता गाउँपालिका,6373,4747,30664,15416,15248
सप्तरी,डाक्नेश्वरी नगरपालिका,10094,7954,48314,24055,24259
सप्तरी,हनुमाननगर कङ्कालिनी नगरपालिका,11130,8680,51926,26330,25596
सप्तरी,कञ्चनरुप नगरपालिका,12662,10277,58882,28949,29933
सप्तरी,खडक नगरपालिका,11355,9432,54193,26139,28054
सप्तरी,महादेवा गाउँपालिका,6522,5322,31048,15737,15311
सप्तरी,राजविराज नगरपालिका,15121,13062,71946,36942,35004
सप्तरी,रुपनी गाउँपालिका,6963,5801,30064,14806,15258
सप्तरी,सप्तकोशी नगरपालिका,5305,4624,23891,11632,12259
सप्तरी,शम्भुनाथ नगरपालिका,8824,7388,39423,18943,20480
सप्तरी,सुरुङ्गा नगरपालिका,10611,8979,49668,23899,25769
सप्तरी,तिलाठी कोईलाडी गाउँपालिका,6874,5366,34257,17459,16798
सप्तरी,तिरहुत गाउँपालिका,5151,4148,23987,12086,11901
सिराहा,अर्नमा गाउँपालिका,5208,4231,28137,13741,14396
सिराहा,औरही गाउँपालिका,5891,4092,27194,13669,13525
सिराहा,बरियारपट्टी गाउँपालिका,5965,4475,29859,14876,14983
सिराहा,भगवानपुर गाउँपालिका,4650,3553,23324,11544,11780
सिराहा,बिष्णुपुर गाउँपालिका,4870,3821,22796,11303,11493
सिराहा,धनगढीमाई नगरपालिका,11133,9657,54244,26617,27627
सिराहा,गोलबजार नगरपालिका,13214,10853,65263,32258,33005
सिराहा,कल्याणपुर नगरपालिका,12491,9869,59986,28789,31197
सिराहा,कर्जन्हा नगरपालिका,8440,6696,38940,18965,19975
सिराहा,लहान नगरपालिका,21488,17832,102955,51063,51892
सिराहा,लक्ष्मीपुर पतारी गाउँपालिका,6666,5235,31103,14912,16191
सिराहा,मिर्चैया नगरपालिका,12905,10496,60086,30054,30032
सिराहा,नरहा गाउँपालिका,4419,3787,23656,12319,11337
सिराहा,नवराजपुर गाउँपालिका,4268,3214,20832,10214,10618
सिराहा,सखुवानान्कारकट्टी गाउँपालिका,4263,3223,20951,10230,10721
सिराहा,सिराहा नगरपालिका,19810,15310,96543,47306,49237
सिराहा,सुखीपुर नगरपालिका,8912,7192,42547,21189,21358
धनुषा ,औरही गाउँपालिका,4846,4036,24338,11773,12565
धनुषा ,बटेश्वर गाउँपालिका,4766,3903,21473,10670,10803
धनुषा ,विदेह नगरपालिका,7764,6156,37881,18446,19435
धनुषा ,क्षिरेश्वरनाथ नगरपालिका,10826,8913,53031,26708,26323
धनुषा ,धनौजी गाउँपालिका,4683,3704,21960,10481,11479
धनुषा ,धनुषाधाम नगरपालिका,10959,9216,53035,26337,26698
धनुषा ,गणेशमान चारनाथ नगरपालिका,9400,8139,44900,21982,22918
धनुषा ,हंसपुर नगरपालिका,8958,7336,44929,21997,22932
धनुषा ,जनकनन्दिनी गाउँपालिका,5627,4480,28267,13556,14711
धनुषा ,जनकपुरधाम उपमहानगरपालिका,41941,32612,195438,100417,95021
धनुषा ,कमला नगरपालिका,9160,7332,45477,22103,23374
धनुषा ,लक्ष्मीनिया गाउँपालिका,6609,5409,33212,16161,17051
धनुषा ,मिथिला बिहारी नगरपालिका,7651,6094,38008,18830,19178
धनुषा ,मिथिला नगरपालिका,10522,9159,47408,23715,23693
धनुषा ,मुखियापट्टी मुसहरमिया गाउँपालिका,5585,4467,29351,14937,14414
धनुषा ,नगराइन नगरपालिका,7962,6426,37949,18682,19267
धनुषा ,सबैला नगरपालिका,12279,10144,62510,30630,31880
धनुषा ,शहीदनगर नगरपालिका,11288,8944,53546,26387,27159
महोत्तरी,औरही नगरपालिका,7841,6376,40834,20496,20338
महोत्तरी,बलवा नगरपालिका,10052,8139,50031,24606,25425
महोत्तरी,बर्दिबास नगरपालिका,15938,13635,68353,34179,34174
महोत्तरी,भँगाहा नगरपालिका,11336,9017,56570,27508,29062
महोत्तरी,एकडारा गाउँपालिका,6000,4735,32060,16099,15961
महोत्तरी,गौशाला नगरपालिका,16090,13367,73008,36367,36641
महोत्तरी,जलेश्वर नगरपालिका,13685,10607,63501,31620,31881
महोत्तरी,लोहरपट्टी नगरपालिका,9627,7658,46336,22359,23977
महोत्तरी,महोत्तरी गाउँपालिका,6845,5430,32652,16211,16441
महोत्तरी,मनरा शिसवा नगरपालिका,9343,7691,49126,24418,24708
महोत्तरी,मटिहानी नगरपालिका,7356,5748,36063,17620,18443
महोत्तरी,पिपरा गाउँपालिका,8514,6459,39500,19764,19736
महोत्तरी,राम गोपालपुर नगरपालिका,6921,5630,36594,18240,18354
महोत्तरी,सम्सी गाउँपालिका,7100,5478,38676,18818,19858
महोत्तरी,सोनमा गाउँपालिका,9252,7524,51736,26647,25089
सर्लाही,बागमती नगरपालिका,10785,9960,45459,22454,23005
सर्लाही,बलरा नगरपालिका,9118,6760,47602,24635,22967
सर्लाही,बरहथवा नगरपालिका,16257,13540,83257,42271,40986
सर्लाही,बसबरिया गाउँपालिका,4675,3908,26406,13495,12911
सर्लाही,विष्णु गाउँपालिका,4784,3587,25870,13350,12520
सर्लाही,ब्रह्मपुरी गाउँपालिका,5383,4048,27878,13831,14047
सर्लाही,चक्रघट्टा गाउँपालिका,5041,4150,29166,15057,14109
सर्लाही,चन्द्रनगर गाउँपालिका,6808,5320,37517,19111,18406
सर्लाही,धनकौल गाउँपालिका,5121,4077,28500,14688,13812
सर्लाही,गोडैटा नगरपालिका,9510,7919,54346,27841,26505
सर्लाही,हरिपुर नगरपालिका,8445,7041,43609,21546,22063
सर्लाही,हरिपुर्वा नगरपालिका,6854,5210,36523,18469,18054
सर्लाही,हरिवन नगरपालिका,11120,9984,51333,25283,26050
सर्लाही,ईश्वरपुर नगरपालिका,13776,11907,68626,34124,34502
सर्लाही,कविलासी नगरपालिका,8150,6702,44688,22487,22201
सर्लाही,कौडेना गाउँपालिका,5805,4478,29226,14638,14588
सर्लाही,लालबन्दी नगरपालिका,15960,13905,67507,33555,33952
सर्लाही,मलंगवा नगरपालिका,10305,7918,53204,27167,26037
सर्लाही,पर्सा गाउँपालिका,4656,3625,24039,12262,11777
सर्लाही,रामनगर गाउँपालिका,5853,4373,31687,16335,15352
रौतहट,बौधीमाई नगरपालिका,6091,4899,39348,20260,19088
रौतहट,वृन्दावन नगरपालिका,8237,6751,50144,24994,25150
रौतहट,चन्द्रपुर नगरपालिका,17237,15034,83350,41245,42105
रौतहट,देवाही गोनाही नगरपालिका,6340,4990,38808,19561,19247
रौतहट,दुर्गा भगवती गाउँपालिका,4136,3369,23226,11809,11417
रौतहट,गढीमाई नगरपालिका,7850,6306,49642,25191,24451
रौतहट,गरुडा नगरपालिका,9765,7796,60009,30685,29324
रौतहट,गौर नगरपालिका,7743,6062,40368,20655,19713
रौतहट,गुजरा नगरपालिका,9682,7989,54089,26391,27698
रौतहट,ईशनाथ नगरपालिका,8084,6289,53402,26821,26581
रौतहट,कटहरिया नगरपालिका,7789,5933,47455,24148,23307
रौतहट,माधव नारायण नगरपालिका,7081,5575,40974,20953,20021
रौतहट,मौलापुर नगरपालिका,5428,4164,32468,16702,15766
रौतहट,परोहा नगरपालिका,7214,5656,46749,23068,23681
रौतहट,फतुवा बिजयपुर नगरपालिका,7777,6323,44358,21882,22476
रौतहट,राजदेवी नगरपालिका,5919,4600,33836,16923,16913
रौतहट,राजपुर नगरपालिका,8254,6205,54372,26939,27433
रौतहट,यमुनामाई गाउँपालिका,4728,3622,28607,14042,14565
बारा,आदर्श कोटवाल गाउँपालिका,5196,4217,29586,15141,14445
बारा,बारागढी गाउँपालिका,5118,4071,29836,15164,14672
बारा,विश्रामपुर गाउँपालिका,4310,3678,23891,12535,11356
बारा,देवताल गाउँपालिका,3936,3143,25082,13388,11694
बारा,जीतपुर सिमरा उपमहानगरपालिका,23677,19848,119148,60461,58687
बारा,कलैया उपमहानगरपालिका,23760,19810,141179,72540,68639
बारा,करैयामाई गाउँपालिका,5154,4026,29045,14583,14462
बारा,कोल्हवी नगरपालिका,11495,9728,46200,22362,23838
बारा,महागढीमाई नगरपालिका,9952,8020,59744,30717,29027
बारा,निजगढ नगरपालिका,8455,7931,36591,18006,18585
बारा,पचरौता नगरपालिका,6402,5128,40252,20468,19784
बारा,परवानीपुर गाउँपालिका,3664,2975,22466,11767,10699
बारा,फेटा गाउँपालिका,5195,4414,28922,14888,14034
बारा,प्रसौनी गाउँपालिका,3400,2924,21747,11146,10601
बारा,सिम्रौनगढ नगरपालिका,9064,7645,53103,27378,25725
बारा,सुवर्ण गाउँपालिका,5584,4743,35875,18528,17347
पर्सा,बहुदरमाई नगरपालिका,7058,5721,43780,22801,20979
पर्सा,बिन्दबासिनी गाउँपालिका,3832,3210,24466,12637,11829
पर्सा,वीरगञ्ज महानगरपालिका,47218,36697,268273,139849,128424
पर्सा,छिपहरमाई गाउँपालिका,4316,3698,26742,13732,13010
पर्सा,धोबीनी गाउँपालिका,3585,3063,22846,11803,11043
पर्सा,जगरनाथपुर गाउँपालिका,5846,4960,32737,16537,16200
पर्सा,जिराभवानी गाउँपालिका,5287,4280,22602,11200,11402
पर्सा,कालिकामाई गाउँपालिका,3788,3099,23740,12232,11508
पर्सा,पकाहा मैनपुर गाउँपालिका,3825,3406,22957,12073,10884
पर्सा,पर्सागढी नगरपालिका,8002,6653,41477,21023,20454
पर्सा,पटेर्वा सुगौली गाउँपालिका,4850,3851,25508,12866,12642
पर्सा,पोखरिया नगरपालिका,6614,5504,38985,20285,18700
पर्सा,सखुवा प्रसौनी गाउँपालिका,6382,5244,35712,17890,17822
पर्सा,ठोरी गाउँपालिका,4546,4333,17494,8346,9148
सिन्धुली,दुधौली नगरपालिका,16231,14869,70679,34227,36452
सिन्धुली,घ्याङलेख गाउँपालिका ,2875,2801,12701,6214,6487
सिन्धुली,गोलन्जोर गाउँपालिका,4537,4340,19012,9296,9716
सिन्धुली,हरिहरपुरगढी गाउँपालिका,5298,5199,26829,13132,13697
सिन्धुली,कमलामाई नगरपालिका,18238,15913,71811,34922,36889
सिन्धुली,मरिण गाउँपालिका,6089,5843,28988,14277,14711
सिन्धुली,फिक्कल गाउँपालिका,3091,3039,14359,7058,7301
सिन्धुली,सुनकोशी गाउँपालिका ,5075,4920,18136,8772,9364
सिन्धुली,तीनपाटन गाउँपालिका,7939,7669,35145,17429,17716
रामेछाप,दोरम्बा शैलुङ गाउँपालिका,5036,4928,17529,8129,9400
रामेछाप,गोकुलगङ्गा गाउँपालिका,4897,4773,18363,8826,9537
रामेछाप,खाँडादेवी गाउँपालिका,5507,5392,19381,9174,10207
रामेछाप,लिखु तामाकोशी गाउँपालिका ,5310,5149,18675,8702,9973
रामेछाप,मन्थली नगरपालिका,11105,10212,40230,18967,21263
रामेछाप,रामेछाप नगरपालिका,6663,6456,25117,11829,13288
रामेछाप,सुनापती गाउँपालिका,4201,4100,14616,6932,7684
रामेछाप,उमाकुण्ड गाउँपालिका,4216,4063,16709,8219,8490
दोलखा,वैतेश्वर गाउँपालिका,5412,5212,17947,8613,9334
दोलखा,भिमेश्वर नगरपालिका,10265,9049,35122,16895,18227
दोलखा,विगु गाउँपालिका,5055,4805,16299,7853,8446
दोलखा,गौरिशंकर गाउँपालिका,4667,4612,15982,7889,8093
दोलखा,जिरी नगरपालिका,4102,3959,15500,7530,7970
दोलखा,कालिन्चोक गाउँपालिका,6268,6046,21210,10354,10856
दोलखा,मेलुङ गाउँपालिका,4877,4759,16051,7571,8480
दोलखा,शैलुङ  गाउँपालिका,5248,5088,18328,9048,9280
दोलखा,तामाकोशी गाउँपालिका,4759,4317,15237,7369,7868
सिन्धुपाल्चोक,बाह्रविसे नगरपालिका,6994,6677,24158,11980,12178
सिन्धुपाल्चोक,बलेफी गाउँपालिका,4730,4467,16465,8062,8403
सिन्धुपाल्चोक,भोटेकोशी गाउँपालिका,3769,3622,14239,7259,6980
सिन्धुपाल्चोक,चौतारा साँगाचोकगढी नगरपालिका,11936,11111,42962,20356,22606
सिन्धुपाल्चोक,हेलम्बु गाउँपालिका,4755,4589,17723,8907,8816
सिन्धुपाल्चोक,ईन्द्रावती गाउँपालिका,6812,6584,25518,12114,13404
सिन्धुपाल्चोक,जुगल गाउँपालिका,4698,4549,19148,9657,9491
सिन्धुपाल्चोक,लिसंखु पाखर गाउँपालिका,3746,3605,11560,5713,5847
सिन्धुपाल्चोक,मेलम्ची नगरपालिका,11349,10811,41170,20073,21097
सिन्धुपाल्चोक,पाँचपोखरी थाङपाल गाउँपालिका,5917,5634,20978,10596,10382
सिन्धुपाल्चोक,सुनकोशी गाउँपालिका ,4597,4509,15307,7376,7931
सिन्धुपाल्चोक,त्रिपुरासुन्दरी गाउँपालिका,3653,3551,12194,5972,6222
काभ्रेपलाञ्चोक,बनेपा नगरपालिका,16973,12545,67629,33180,34449
काभ्रेपलाञ्चोक,बेथानचोक गाउँपालिका,3900,3730,14996,7229,7767
काभ्रेपलाञ्चोक,भुम्लु गाउँपालिका,4524,4407,15858,7607,8251
काभ्रेपलाञ्चोक,चौंरीदेउराली गाउँपालिका,4181,4084,14106,6668,7438
काभ्रेपलाञ्चोक,धुलिखेल नगरपालिका,8808,7309,36183,18501,17682
काभ्रेपलाञ्चोक,खानीखोला गाउँपालिका,2484,2455,12375,6131,6244
काभ्रेपलाञ्चोक,महाभारत गाउँपालिका,3327,3297,16148,7933,8215
काभ्रेपलाञ्चोक,मण्डनदेउपुर नगरपालिका,8220,7861,31261,15335,15926
काभ्रेपलाञ्चोक,नमोबुद्ध नगरपालिका,7406,6988,26280,12579,13701
काभ्रेपलाञ्चोक,पनौती नगरपालिका,12986,11555,52078,25457,26621
काभ्रेपलाञ्चोक,पाँचखाल नगरपालिका,9295,8783,35992,17471,18521
काभ्रेपलाञ्चोक,रोशी गाउँपालिका,6148,6039,23551,11458,12093
काभ्रेपलाञ्चोक,तेमाल गाउँपालिका,4930,4872,16959,8197,8762
ललितपुर ,बागमती गाउँपालिका,2800,2735,11196,5637,5559
ललितपुर ,गोदावरी नगरपालिका,24771,20966,100972,49707,51265
ललितपुर ,कोन्ज्योसोम गाउँपालिका,2176,2148,9042,4499,4543
ललितपुर ,ललितपुर महानगरपालिका,77872,49044,299843,150702,149141
ललितपुर ,महालक्ष्मी नगरपालिका,31509,20659,118710,60388,58322
ललितपुर ,महाङ्काल गाउँपालिका,1878,1836,7861,3913,3948
भक्तपुर ,भक्तपुर नगरपालिका,18854,12200,78854,39664,39190
भक्तपुर ,चाँगुनारायण नगरपालिका,21946,17373,88612,44073,44539
भक्तपुर ,मध्यपुर थिमी नगरपालिका,31768,17639,119955,60954,59001
भक्तपुर ,सूर्यविनायक नगरपालिका,35885,23637,137971,68971,69000
काठमाडौं,बुढानिलकण्ठ नगरपालिका,47169,26910,179688,89284,90404
काठमाडौं,चन्द्रागिरी नगरपालिका,36012,22070,136928,68350,68578
काठमाडौं,दक्षिणकाली नगरपालिका,6527,5568,26744,13179,13565
काठमाडौं,गोकर्णेश्वर नगरपालिका,40114,19098,151200,74453,76747
काठमाडौं,कागेश्वरी मनहरा नगरपालिका,34794,21028,133327,66138,67189
काठमाडौं,काठमाण्डौ महानगरपालिका,231714,105649,845767,431501,414266
काठमाडौं,किर्तिपुर नगरपालिका,24211,12676,81782,43378,38404
काठमाडौं,नागार्जुन नगरपालिका,31323,17466,115507,57631,57876
काठमाडौं,शंखरापुर नगरपालिका,7275,6479,30414,15188,15226
काठमाडौं,तारकेश्वर नगरपालिका,41364,21623,151508,75300,76208
काठमाडौं,टोखा नगरपालिका,37413,17239,135741,67396,68345
नुवाकोट,बेलकोटगढी नगरपालिका,9464,9244,35200,17139,18061
नुवाकोट,विदुर नगरपालिका,15604,13911,60111,29043,31068
नुवाकोट,दुप्चेश्वर गाउँपालिका,5195,5023,21019,10473,10546
नुवाकोट,ककनी गाउँपालिका,6388,6012,24323,11969,12354
नुवाकोट,किस्पाङ गाउँपालिका,3969,3853,14122,6920,7202
नुवाकोट,लिखु गाउँपालिका ,4604,4374,17737,8646,9091
नुवाकोट,म्यागङ गाउँपालिका,3755,3595,12417,6086,6331
नुवाकोट,पञ्चकन्या गाउँपालिका,3629,3539,13864,6771,7093
नुवाकोट,शिवपुरी गाउँपालिका,4877,4795,16979,8115,8864
नुवाकोट,सुर्यगढी गाउँपालिका,3842,3776,14929,7256,7673
नुवाकोट,तादी गाउँपालिका,4031,3867,16055,7911,8144
नुवाकोट,तारकेश्वर गाउँपालिका,3792,3735,14164,6670,7494
रसुवा,गोसाईकुण्ड गाउँपालिका,2477,2149,8043,4071,3972
रसुवा,कालीका गाउँपालिका,2474,2412,10172,5011,5161
रसुवा,नौकुण्ड गाउँपालिका,2899,2878,12095,6059,6036
रसुवा,आमाछोदिङमो गाउँपालिका,1727,1688,6673,3486,3187
रसुवा,उत्तरगया गाउँपालिका,2264,2235,8571,4232,4339
धादिङ्ग,बेनीघाट रोराङ्ग गाउँपालिका,7791,6979,34473,17542,16931
धादिङ्ग,धुनीबेंशी नगरपालिका,7235,6777,29126,14411,14715
धादिङ्ग,गजुरी गाउँपालिका,6909,6306,28756,14471,14285
धादिङ्ग,गल्छी गाउँपालिका,6212,5783,24206,11875,12331
धादिङ्ग,गङ्गाजमुना गाउँपालिका,5305,5183,19460,9494,9966
धादिङ्ग,ज्वालामूखी गाउँपालिका,6116,5972,21202,9898,11304
धादिङ्ग,खनियाबास गाउँपालिका,2640,2618,10680,5175,5505
धादिङ्ग,नेत्रावती डबजोङ गाउँपालिका,3295,3242,11271,5390,5881
धादिङ्ग,नीलकण्ठ नगरपालिका,16579,14281,58151,27136,31015
धादिङ्ग,रुबी भ्याली गाउँपालिका,3005,2989,10472,5261,5211
धादिङ्ग,सिद्धलेक गाउँपालिका,5883,5795,22212,10652,11560
धादिङ्ग,थाक्रे गाउँपालिका,7745,7142,31554,15797,15757
धादिङ्ग,त्रिपुरासुन्दरी गाउँपालिका,5748,5596,21188,10105,11083
मकवानपुर,बागमती गाउँपालिका,6498,6195,30625,15111,15514
मकवानपुर,बकैया गाउँपालिका,9028,8664,40671,19947,20724
मकवानपुर,भिमफेदी गाउँपालिका,5128,4939,21626,10668,10958
मकवानपुर,हेटौंडा उपमहानगरपालिका,47027,39425,195951,97324,98627
मकवानपुर,ईन्द्रसरोवर गाउँपालिका,3415,3217,13758,6739,7019
मकवानपुर,कैलाश गाउँपालिका,4487,4400,21992,11140,10852
मकवानपुर,मकवानपुरगढी गाउँपालिका,5342,5239,24252,12169,12083
मकवानपुर,मनहरी गाउँपालिका,10762,10097,47144,22986,24158
मकवानपुर,राक्सिराङ्ग गाउँपालिका,5077,5043,25871,13147,12724
मकवानपुर,थाहा नगरपालिका,9842,8995,39163,19241,19922
चितवन,भरतपुर महानगरपालिका,98288,77838,369377,179744,189633
चितवन,इच्छाकामना गाउँपालिका,6174,5517,26965,13599,13366
चितवन,कालिका नगरपालिका,12466,11623,52779,25740,27039
चितवन,खैरहनी नगरपालिका,16757,14650,68675,33104,35571
चितवन,माडी नगरपालिका,10227,9710,38550,18257,20293
चितवन,राप्ती नगरपालिका,15459,14390,66426,32609,33817
चितवन,रत्ननगर नगरपालिका,22670,19901,90978,44120,46858
गोरखा,आरुघाट गाउँपालिका,6220,5950,21876,10409,11467
गोरखा,अजिरकोट गाउँपालिका,3667,3589,13002,6389,6613
गोरखा,भिमसेनथापा गाउँपालिका,5265,5186,17118,7819,9299
गोरखा,चुमनुव्री गाउँपालिका,2134,2036,6789,3240,3549
गोरखा,धार्चे गाउँपालिका,3790,3683,14563,7025,7538
गोरखा,गण्डकी गाउँपालिका,5688,5537,21662,10414,11248
गोरखा,गोरखा नगरपालिका,15298,12641,53285,25279,28006
गोरखा,पालुङटार नगरपालिका,11317,10727,37274,17431,19843
गोरखा,शहीद लखन गाउँपालिका,6812,6554,22429,10492,11937
गोरखा,सिरानचोक गाउँपालिका,6026,5907,19829,9352,10477
गोरखा,बारपाक सुलिकोट गाउँपालिका,6583,6426,23222,10921,12301
लमजुङ,बेसीशहर नगरपालिका,11308,8781,38562,18525,20037
लमजुङ,दोर्दी गाउँपालिका,4597,4462,15639,7585,8054
लमजुङ,दुधपोखरी गाउँपालिका,2492,2470,8558,4178,4380
लमजुङ,क्व्होलासोथार गाउँपालिका ,2285,2228,8008,3827,4181
लमजुङ,मध्यनेपाल नगरपालिका,6528,6002,21373,9767,11606
लमजुङ,मर्स्याङदी गाउँपालिका ,4620,4455,17267,8421,8846
लमजुङ,राईनास नगरपालिका,5009,4872,17207,8309,8898
लमजुङ,सुन्दरबजार नगरपालिका,8034,6831,26866,12597,14269
तनहुँ,आँबुखैरेनी गाउँपालिका,6284,4758,22349,10791,11558
तनहुँ,बन्दिपुर गाउँपालिका,5418,4712,19403,9251,10152
तनहुँ,भानु नगरपालिका,13064,12351,43255,19943,23312
तनहुँ,भिमाद नगरपालिका,8964,7965,33077,15166,17911
तनहुँ,व्यास नगरपालिका,24078,19547,80944,37669,43275
तनहुँ,देवघाट गाउँपालिका,3878,3653,14941,7115,7826
तनहुँ,घिरिङ गाउँपालिका,4490,4102,15038,7013,8025
तनहुँ,म्याग्दे गाउँपालिका,6532,5857,23385,10781,12604
तनहुँ,ऋषिङ्ग गाउँपालिका,4981,4611,18821,8590,10231
तनहुँ,शुक्लागण्डकी नगरपालिका,15479,14086,55749,26023,29726
स्याङ्गजा,आँधीखोला गाउँपालिका,4718,4278,14970,6916,8054
स्याङ्गजा,अर्जुनचौपारी गाउँपालिका,3810,3549,14094,6495,7599
स्याङ्गजा,भीरकोट नगरपालिका,6226,5644,22617,10320,12297
स्याङ्गजा,बिरुवा गाउँपालिका,3980,3775,13900,6571,7329
स्याङ्गजा,चापाकोट नगरपालिका,6389,5726,22787,10398,12389
स्याङ्गजा,गल्याङ नगरपालिका,7971,7226,31125,14413,16712
स्याङ्गजा,हरिनास गाउँपालिका,3591,3318,12979,5953,7026
स्याङ्गजा,कालीगण्डकी गाउँपालिका,4946,4666,18008,8242,9766
स्याङ्गजा,फेदीखोला गाउँपालिका,3222,2919,10786,5035,5751
स्याङ्गजा,पुतलीबजार नगरपालिका,12152,10390,42079,19440,22639
स्याङ्गजा,वालिङ नगरपालिका,13705,11365,50932,23657,27275
कास्की,अन्नपूर्ण गाउँपालिका,6406,5811,22517,10863,11654
कास्की,माछापुच्छ्रे गाउँपालिका,6144,5509,22013,10762,11251
कास्की,मादी गाउँपालिका,4115,4014,16318,8136,8182
कास्की,पोखरा महानगरपालिका,143137,101669,518452,250999,267453
कास्की,रूपा गाउँपालिका,3674,3569,14741,7093,7648
मनाङ,चामे गाउँपालिका,391,333,1272,728,544
मनाङ,नार्पा भूमि गाउँपालिका,125,125,398,170,228
मनाङ,नासोँ गाउँपालिका,471,441,1671,831,840
मनाङ,मनाङ ङिस्याङ गाउँपालिका,558,548,1584,818,766
मुस्ताङ,वारागुङ मुक्तिक्षेत्र गाउँपालिका,738,666,2611,1336,1275
मुस्ताङ,लो-घेकर दामोदरकुण्ड गाउँपालिका,459,444,1535,748,787
मुस्ताङ,घरपझोङ गाउँपालिका,1169,921,4875,2904,1971
मुस्ताङ,लोमन्थाङ गाउँपालिका,540,539,1997,1132,865
मुस्ताङ,थासाङ गाउँपालिका,845,698,3578,2054,1524
म्याग्दी,अन्नपूर्ण गाउँपालिका,3618,3340,12351,6078,6273
म्याग्दी,बेनी नगरपालिका,9465,7202,33062,15572,17490
म्याग्दी,धवलागिरी गाउँपालिका,3192,3008,12604,6158,6446
म्याग्दी,मालिका गाउँपालिका,4818,4336,18346,8999,9347
म्याग्दी,मंगला गाउँपालिका,3934,3699,14772,7030,7742
म्याग्दी,रघुगंगा गाउँपालिका,4174,3767,14232,6857,7375
पर्वत,बिहादी गाउँपालिका,3192,3063,12521,5960,6561
पर्वत,जलजला गाउँपालिका,6095,5140,21375,10259,11116
पर्वत,कुश्मा नगरपालिका,11906,9740,38774,18543,20231
पर्वत,महाशिला गाउँपालिका,2093,1964,8233,3867,4366
पर्वत,मोदी गाउँपालिका,5148,4618,18018,8611,9407
पर्वत,पैयूँ गाउँपालिका,3292,2995,12705,6025,6680
पर्वत,फलेवास नगरपालिका,5875,5529,20726,9534,11192
बागलुङ,वडिगाड गाउँपालिका,6819,6324,28797,13487,15310
बागलुङ,बाग्लुङ नगरपालिका,16399,12924,57030,26588,30442
बागलुङ,वरेङ गाउँपालिका,2981,2796,11162,5070,6092
बागलुङ,ढोरपाटन नगरपालिका,7661,6535,30779,14306,16473
बागलुङ,गल्कोट नगरपालिका,7912,7314,30503,14473,16030
बागलुङ,जैमिनी नगरपालिका,6912,6555,24784,11310,13474
बागलुङ,काठेखोला गाउँपालिका,5961,5743,22732,10387,12345
बागलुङ,निसीखोला गाउँपालिका,5711,5499,23215,10566,12649
बागलुङ,तमानखोला गाउँपालिका,2622,2453,9795,4667,5128
बागलुङ,ताराखोला गाउँपालिका,2356,2302,10167,5010,5157
नवलपरासी (बर्दघाट सुस्ता पूर्व),विनयीत्रिवेणी गाउँपालिका,9348,8651,39201,18664,20537
नवलपरासी (बर्दघाट सुस्ता पूर्व),बुलिङटार गाउँपालिका,3569,3305,14596,7007,7589
नवलपरासी (बर्दघाट सुस्ता पूर्व),बौदीकाली गाउँपालिका,2914,2676,11339,5164,6175
नवलपरासी (बर्दघाट सुस्ता पूर्व),देवचुली नगरपालिका,14836,13127,59400,28133,31267
नवलपरासी (बर्दघाट सुस्ता पूर्व),गैंडाकोट नगरपालिका,20701,17151,80737,38725,42012
नवलपरासी (बर्दघाट सुस्ता पूर्व),हुप्सेकोट गाउँपालिका,6250,5865,26861,12346,14515
नवलपरासी (बर्दघाट सुस्ता पूर्व),कावासोती नगरपालिका,22184,19568,87176,40890,46286
नवलपरासी (बर्दघाट सुस्ता पूर्व),मध्यविन्दु नगरपालिका,15549,14345,61548,28291,33257
गुल्मी,चन्द्रकोट गाउँपालिका,5148,4732,18751,8605,10146
गुल्मी,छत्रकोट गाउँपालिका,5320,5073,19239,8601,10638
गुल्मी,धुर्कोट गाउँपालिका,5405,5036,18699,8285,10414
गुल्मी,गुल्मीदरबार गाउँपालिका,5288,5032,19413,8490,10923
गुल्मी,इस्मा गाउँपालिका,5013,4777,18530,8453,10077
गुल्मी,कालिगण्डकी गाउँपालिका,3793,3640,15106,7085,8021
गुल्मी,मदाने गाउँपालिका,5274,4961,19820,8985,10835
गुल्मी,मालिका गाउँपालिका,5273,5040,20173,9263,10910
गुल्मी,मुसिकोट नगरपालिका,7135,6761,28761,13371,15390
गुल्मी,रेसुङ्गा नगरपालिका,9129,6865,31677,14696,16981
गुल्मी,रुरुक्षेत्र गाउँपालिका,4691,4348,16638,7627,9011
गुल्मी,सत्यवती गाउँपालिका,5252,4953,19751,9056,10695
पाल्पा,बगनासकाली गाउँपालिका,4648,4423,16934,7683,9251
पाल्पा,माथागढी गाउँपालिका,5840,5553,24024,11222,12802
पाल्पा,निस्दी गाउँपालिका,4075,3772,17629,8137,9492
पाल्पा,पुर्वखोला गाउँपालिका,4138,3660,16145,7147,8998
पाल्पा,रैनादेवी छहरा गाउँपालिका,6390,6046,23124,10491,12633
पाल्पा,रम्भा गाउँपालिका,4696,4339,17077,7565,9512
पाल्पा,रामपुर नगरपालिका,10821,9111,39190,17775,21415
पाल्पा,रिब्दीकोट गाउँपालिका,4459,4236,15636,7195,8441
पाल्पा,तानसेन नगरपालिका,14865,10919,51470,23927,27543
पाल्पा,तिनाउ गाउँपालिका,4326,4164,18291,8628,9663
नवलपरासी (बर्दघाट सुस्ता पश्चिम),बर्दघाट नगरपालिका,18240,16430,75017,35180,39837
नवलपरासी (बर्दघाट सुस्ता पश्चिम),पाल्हीनन्दन गाउँपालिका,7383,6165,40325,20662,19663
नवलपरासी (बर्दघाट सुस्ता पश्चिम),प्रतापपुर गाउँपालिका,10753,9234,50326,25016,25310
नवलपरासी (बर्दघाट सुस्ता पश्चिम),रामग्राम नगरपालिका,13081,11037,64150,31842,32308
नवलपरासी (बर्दघाट सुस्ता पश्चिम),सरावल गाउँपालिका,8840,7576,42217,20691,21526
नवलपरासी (बर्दघाट सुस्ता पश्चिम),सुनवल नगरपालिका,17689,15871,72621,34316,38305
नवलपरासी (बर्दघाट सुस्ता पश्चिम),सुस्ता गाउँपालिका,7892,6946,39798,19365,20433
रुपन्देही,बुटवल उपमहानगरपालिका,51099,36989,195054,95705,99349
रुपन्देही,देवदह नगरपालिका,17582,15624,71806,33747,38059
रुपन्देही,गैडहवा गाउँपालिका,10020,8612,56529,28000,28529
रुपन्देही,कन्चन गाउँपालिका,10483,9828,42528,19295,23233
रुपन्देही,कोटहीमाई गाउँपालिका,7921,5939,46417,23527,22890
रुपन्देही,लुम्बिनी साँस्कृतिक नगरपालिका,13854,10736,88090,43706,44384
रुपन्देही,मर्चवारी गाउँपालिका,6972,5305,41058,20632,20426
रुपन्देही,मायादेवी गाउँपालिका,10040,8003,57341,28991,28350
रुपन्देही,ओमसतिया गाउँपालिका,8218,6683,41080,20332,20748
रुपन्देही,रोहिणी गाउँपालिका,8096,6349,43277,21836,21441
रुपन्देही,सैनामैना नगरपालिका,19657,17572,78477,36547,41930
रुपन्देही,सम्मरीमाई गाउँपालिका,7303,5164,43300,21691,21609
रुपन्देही,सिद्धार्थनगर नगरपालिका,16011,12329,76307,38136,38171
रुपन्देही,सियारी गाउँपालिका,9060,7883,45274,22100,23174
रुपन्देही,शुद्धोधन गाउँपालिका,8717,7619,41472,20352,21120
रुपन्देही,तिलोत्तमा नगरपालिका,36399,30452,149657,71700,77957
कपिलवस्तु,बाणगंगा नगरपालिका,23482,21157,97114,45820,51294
कपिलवस्तु,विजयनगर गाउँपालिका,7144,6361,43440,21562,21878
कपिलवस्तु,बुद्धभूमि नगरपालिका,15581,13717,77281,37580,39701
कपिलवस्तु,कपिलवस्तु नगरपालिका,15555,12871,89969,44505,45464
कपिलवस्तु,कृष्णनगर नगरपालिका,10889,8734,70969,35449,35520
कपिलवस्तु,महाराजगञ्ज नगरपालिका,9945,8084,65668,33257,32411
कपिलवस्तु,मायादेवी गाउँपालिका,8383,6623,57121,28014,29107
कपिलवस्तु,शिवराज नगरपालिका,16072,13960,84454,41098,43356
कपिलवस्तु,शुद्धोधन गाउँपालिका,8593,6770,53417,26258,27159
कपिलवस्तु,यसोधरा गाउँपालिका,7045,5462,45169,22030,23139
अर्घाखाँची,भूमिकास्थान नगरपालिका,7891,7403,28317,12687,15630
अर्घाखाँची,छत्रदेव गाउँपालिका,6263,5930,21691,9676,12015
अर्घाखाँची,मालारानी गाउँपालिका,6842,6501,23780,10747,13033
अर्घाखाँची,पाणिनी गाउँपालिका,6214,5915,22330,10064,12266
अर्घाखाँची,सन्धिखर्क नगरपालिका,12322,10261,42528,19507,23021
अर्घाखाँची,शितगंगा नगरपालिका,9541,9002,37888,17787,20101
प्युठान,ऐरावती गाउँपालिका,5145,4628,20404,9074,11330
प्युठान,गौमुखी गाउँपालिका,5616,5380,26000,12006,13994
प्युठान,झिमरुक गाउँपालिका,6592,6130,26491,11935,14556
प्युठान,मल्लरानी गाउँपालिका,4152,3743,15846,6866,8980
प्युठान,माण्डवी गाउँपालिका,3904,3469,15778,7005,8773
प्युठान,नौबहिनी गाउँपालिका,7163,6781,32524,14916,17608
प्युठान,प्यूठान नगरपालिका,11500,10175,42094,18945,23149
प्युठान,सरुमारानी गाउँपालिका,4488,4125,19370,8545,10825
प्युठान,स्वर्गद्वारी नगरपालिका ,8400,7739,32127,14041,18086
रोल्पा,परिवर्तन गाउँपालिका,4765,4567,22001,10252,11749
रोल्पा,लुङ्ग्री गाउँपालिका,5668,5486,26539,12348,14191
रोल्पा,माडी गाउँपालिका,4143,4023,18013,8431,9582
रोल्पा,रोल्पा नगरपालिका,8836,7464,35644,16410,19234
रोल्पा,रुन्टीगढी गाउँपालिका,6387,6055,29094,13734,15360
रोल्पा,सुनिल स्मृति गाउँपालिका,7066,6462,30523,13983,16540
रोल्पा,गंगादेव गाउँपालिका,4474,4423,21738,10278,11460
रोल्पा,सुनछहरी गाउँपालिका,3607,3505,17281,8298,8983
रोल्पा,थबाङ गाउँपालिका,2575,2345,11008,5159,5849
रोल्पा,त्रिवेणी गाउँपालिका,5468,5257,23190,10941,12249
रुकुम-पूर्व,भूमे गाउँपालिका,4194,3849,19835,9425,10410
रुकुम-पूर्व,पुथा उत्तरगंगा गाउँपालिका,4573,3925,18954,9473,9481
रुकुम-पूर्व,सिस्ने गाउँपालिका,4396,3833,18751,9122,9629
दाङ्ग,बबई गाउँपालिका,7538,7171,31317,14527,16790
दाङ्ग,बंगलाचुली गाउँपालिका,5173,4951,22877,10276,12601
दाङ्ग,दंगीशरण गाउँपालिका,5897,5579,23672,11436,12236
दाङ्ग,गढवा गाउँपालिका,10084,9448,46275,22650,23625
दाङ्ग,घोराही उपमहानगरपालिका,51619,45240,201079,94384,106695
दाङ्ग,लमही नगरपालिका,13862,12482,58884,28257,30627
दाङ्ग,राजपुर गाउँपालिका,5896,5634,28410,14171,14239
दाङ्ग,राप्ती गाउँपालिका,11837,10940,52158,24720,27438
दाङ्ग,शान्तिनगर गाउँपालिका,7137,6792,27666,12872,14794
दाङ्ग,तुल्सीपुर उपमहानगरपालिका,46699,41012,180734,85701,95033
बाँके,बैजनाथ गाउँपालिका,16765,15439,70315,32739,37576
बाँके,डुडुवा गाउँपालिका,8112,6152,43039,21798,21241
बाँके,जानकी गाउँपालिका,9124,7263,46536,23386,23150
बाँके,खजुरा गाउँपालिका,13885,12213,63749,30284,33465
बाँके,कोहलपुर नगरपालिका,24346,21251,100289,48324,51965
बाँके,नरैनापुर गाउँपालिका,8680,6941,43698,21822,21876
बाँके,नेपालगञ्ज उपमहानगरपालिका,35517,26491,166258,83311,82947
बाँके,राप्ती सोनारी गाउँपालिका,15491,14380,67782,32015,35767
बर्दिया,बढैयाताल गाउँपालिका,12736,11826,52056,24042,28014
बर्दिया,बाँसगढी नगरपालिका,15149,13965,63400,29486,33914
बर्दिया,बारबर्दिया नगरपालिका,16950,15852,72892,34353,38539
बर्दिया,गेरुवा गाउँपालिका,7788,7613,33742,15525,18217
बर्दिया,गुलरिया नगरपालिका,16141,14177,74868,37086,37782
बर्दिया,मधुवन नगरपालिका,12474,11647,51173,23570,27603
बर्दिया,राजापुर नगरपालिका,13711,13191,61431,29166,32265
बर्दिया,ठाकुरबाबा नगरपालिका,11480,10646,49360,22853,26507
रुकुम - पश्चिम,आठबिसकोट नगरपालिका,7603,7094,35929,17743,18186
रुकुम - पश्चिम,बाँफिकोट गाउँपालिका,4827,4398,20940,10085,10855
रुकुम - पश्चिम,चौरजहारी नगरपालिका,6791,5957,29255,14170,15085
रुकुम - पश्चिम,मुसिकोट नगरपालिका,8793,7425,33871,16091,17780
रुकुम - पश्चिम,सानीभेरी गाउँपालिका,5313,4897,24778,12152,12626
रुकुम - पश्चिम,त्रिवेणी गाउँपालिका,4375,4231,20466,9775,10691
सल्यान,बागचौर नगरपालिका,7539,7212,34053,16496,17557
सल्यान,बनगाड कुपिण्डे नगरपालिका,7893,7423,33758,16237,17521
सल्यान,छत्रेश्वरी गाउँपालिका,5135,4847,21368,10115,11253
सल्यान,दार्मा गाउँपालिका,4270,4006,19998,9699,10299
सल्यान,सिद्ध कुमाख गाउँपालिका,2892,2786,13135,6274,6861
सल्यान,कालिमाटी गाउँपालिका,4994,4734,22498,11126,11372
सल्यान,कपुरकोट गाउँपालिका,3978,3864,17548,8410,9138
सल्यान,कुमाख गाउँपालिका,5582,5149,24858,12088,12770
सल्यान,शारदा नगरपालिका,8992,8122,34684,16516,18168
सल्यान,त्रिवेणी गाउँपालिका,4125,3841,16768,7992,8776
सुर्खेत,बराहताल गाउँपालिका,6240,6059,25562,12248,13314
सुर्खेत,भेरीगंगा नगरपालिका,11599,10524,48581,22833,25748
सुर्खेत,वीरेन्द्रनगर नगरपालिका,39391,31847,154886,75921,78965
सुर्खेत,चौकुने गाउँपालिका,5358,4897,27006,13289,13717
सुर्खेत,चिङ्गाड  गाउँपालिका,3240,3066,15752,7405,8347
सुर्खेत,गुर्भाकोट नगरपालिका,11923,10960,49394,23162,26232
सुर्खेत,लेकबेशी नगरपालिका,7475,7134,31791,14978,16813
सुर्खेत,पञ्चपुरी नगरपालिका,7979,7326,36062,17530,18532
सुर्खेत,सिम्ता गाउँपालिका,6121,5475,24298,10740,13558
दैलेख,आठबीस नगरपालिका,6246,4951,31839,15565,16274
दैलेख,भगवतीमाई गाउँपालिका,3627,3344,18366,9083,9283
दैलेख,भैरवी गाउँपालिका,4198,3755,17981,8377,9604
दैलेख,चामुण्डा बिन्द्रासैनी नगरपालिका,5192,4475,26575,13044,13531
दैलेख,दुल्लु नगरपालिका,9208,8353,39582,18506,21076
दैलेख,डुङ्गेश्वर गाउँपालिका,3436,3163,14597,6940,7657
दैलेख,गुराँस गाउँपालिका,4562,4358,21284,10483,10801
दैलेख,महाबु गाउँपालिका,4021,3652,18037,8316,9721
दैलेख,नारायण नगरपालिका,6668,5421,25803,12222,13581
दैलेख,नौमुले गाउँपालिका,4517,4162,20589,10032,10557
दैलेख,ठाँटीकाँध गाउँपालिका,4033,3142,18666,9107,9559
जाजरकोट,बारेकोट गाउँपालिका,3901,3485,22038,11010,11028
जाजरकोट,भेरी नगरपालिका,8962,7745,38370,18636,19734
जाजरकोट,छेडागाड नगरपालिका,7431,6888,38027,18852,19175
जाजरकोट,जुनीचाँदे गाउँपालिका,4356,3967,23823,11979,11844
जाजरकोट,कुसे गाउँपालिका,4520,4199,23529,11636,11893
जाजरकोट,शिवालय गाउँपालिका,2820,2598,14720,7270,7450
जाजरकोट,नलगाड नगरपालिका,6064,5427,28858,14412,14446
डोल्पा,छार्का ताङसोङ गाउँपालिका,320,306,1713,839,874
डोल्पा,डोल्पो बुद्ध गाउँपालिका,543,542,2462,1206,1256
डोल्पा,जगदुल्ला गाउँपालिका,600,511,2581,1289,1292
डोल्पा,काईके गाउँपालिका,926,715,4124,1931,2193
डोल्पा,मुड्केचुला गाउँपालिका,1206,1078,5875,2975,2900
डोल्पा,शे फोक्सुण्डो गाउँपालिका,818,805,3717,1775,1942
डोल्पा,ठुली भेरी नगरपालिका,2380,1770,10187,5113,5074
डोल्पा,त्रिपुरासुन्दरी नगरपालिका,2636,2268,12300,6148,6152
जुम्ला,चन्दननाथ नगरपालिका,5367,4166,20973,10475,10498
जुम्ला,गुठिचौर गाउँपालिका,2451,2205,10891,5344,5547
जुम्ला,हिमा गाउँपालिका,2104,2062,12804,6388,6416
जुम्ला,कनकासुन्दरी गाउँपालिका,2786,2733,13687,6807,6880
जुम्ला,पातारासी गाउँपालिका,3374,3191,16881,8349,8532
जुम्ला,सिंजा गाउँपालिका,2427,2271,12744,6561,6183
जुम्ला,तातोपानी गाउँपालिका,3321,3190,15721,7728,7993
जुम्ला,तिला गाउँपालिका,2666,2582,14692,7261,7431
कालीकोट,शुभ कालिका गाउँपालिका,2769,2311,13900,6784,7116
कालीकोट,खाँडाचक्र नगरपालिका,4132,3266,23336,11948,11388
कालीकोट,महावै गाउँपालिका,1666,1364,8334,4072,4262
कालीकोट,नरहरिनाथ गाउँपालिका,4422,3668,22414,11109,11305
कालीकोट,पचालझरना गाउँपालिका,2509,2196,13683,6837,6846
कालीकोट,पलाता गाउँपालिका,2895,2683,17658,9018,8640
कालीकोट,रास्कोट नगरपालिका,3076,2836,16469,8059,8410
कालीकोट,सान्नी त्रिवेणी गाउँपालिका,2352,2088,12864,6363,6501
कालीकोट,तिलागुफा नगरपालिका,3135,2517,16259,8053,8206
मुगु,छायाँनाथ रारा नगरपालिका,4917,4529,25692,13022,12670
मुगु,खत्याड गाउँपालिका,3567,3429,19301,9840,9461
मुगु,मुगुम कार्मारोंग गाउँपालिका,1399,1364,7301,3506,3795
मुगु,सोरु गाउँपालिका,2652,2469,14364,7080,7284
हुम्ला,अदानचुली गाउँपालिका,1481,1344,8110,4012,4098
हुम्ला,चंखेली गाउँपालिका,1196,1175,6625,3367,3258
हुम्ला,खार्पुनाथ गाउँपालिका,1545,1330,6975,3465,3510
हुम्ला,नाम्खा गाउँपालिका,868,850,4506,2304,2202
हुम्ला,सर्केगाड गाउँपालिका,2211,2016,11040,5669,5371
हुम्ला,सिमकोट गाउँपालिका,3007,2512,12130,6101,6029
हुम्ला,ताँजाकोट गाउँपालिका,1176,1086,6110,3064,3046
बाजुरा,बडिमालिका नगरपालिका,4082,3143,18432,9253,9179
बाजुरा,बुढीगंगा नगरपालिका,4680,3875,20072,9259,10813
बाजुरा,बुढीनन्दा नगरपालिका,4317,3195,20745,10214,10531
बाजुरा,खप्तड छेडेदह गाउँपालिका,3627,2878,19274,9326,9948
बाजुरा,गौमुल गाउँपालिका,1731,1588,8765,4373,4392
बाजुरा,हिमाली गाउँपालिका,2092,1716,10503,5284,5219
बाजुरा,जगन्‍नाथ गाउँपालिका,1965,1687,10205,4938,5267
बाजुरा,स्वामीकार्तिक खापर गाउँपालिका,2392,2242,13013,6593,6420
बाजुरा,त्रिवेणी नगरपालिका,4036,3567,17989,8368,9621
बझाङ,बित्थडचिर गाउँपालिका,3273,2728,16854,8301,8553
बझाङ,बुंगल नगरपालिका,6242,5357,33487,15885,17602
बझाङ,छबिस पाथिभेरा गाउँपालिका,3125,2792,14515,6770,7745
बझाङ,दुर्गाथली गाउँपालिका,2606,2282,11414,5149,6265
बझाङ,जयपृथ्वी नगरपालिका,5034,4088,21973,10560,11413
बझाङ,साइपाल गाउँपालिका ,456,454,2681,1330,1351
बझाङ,केदारस्युँ गाउँपालिका,4389,3768,21697,10000,11697
बझाङ,खप्तडछान्ना गाउँपालिका,3100,2453,13751,6238,7513
बझाङ,मष्टा गाउँपालिका,2608,2519,13584,6518,7066
बझाङ,सूर्मा गाउँपालिका,1835,1593,11248,5609,5639
बझाङ,तलकोट गाउँपालिका,2238,2063,11858,5454,6404
बझाङ,थलारा गाउँपालिका,3462,2819,15961,7104,8857
अछाम,बान्नीगढी जयगढ गाउँपालिका,3144,2309,13639,5887,7752
अछाम,चौरपाटी गाउँपालिका,4822,3960,22407,9985,12422
अछाम,ढकारी गाउँपालिका,4373,3501,22553,10813,11740
अछाम,कमलबजार नगरपालिका,4590,3730,20947,9480,11467
अछाम,मंगलसेन नगरपालिका,6231,4587,26843,12101,14742
अछाम,मेल्लेख गाउँपालिका,4752,3628,23096,10670,12426
अछाम,पन्चदेवल विनायक नगरपालिका,5432,4466,26316,12062,14254
अछाम,रामारोशन गाउँपालिका,4959,3876,22676,10759,11917
अछाम,साँफेबगर नगरपालिका,6382,4883,25990,11965,14025
अछाम,तुर्माखाँद गाउँपालिका,5277,4428,24440,11668,12772
डोटी,आदर्श गाउँपालिका,5449,4204,24911,11141,13770
डोटी,बडीकेदार गाउँपालिका,2984,2762,15078,7555,7523
डोटी,बोगटान फुड्सिल गाउँपालिका,3198,2774,15912,7488,8424
डोटी,दिपायल सिलगढी नगरपालिका,8601,6111,36906,17884,19022
डोटी,जोरायल गाउँपालिका,4432,4092,20364,10251,10113
डोटी,के.आई.सिं. गाउँपालिका,4731,3975,20830,9130,11700
डोटी,पूर्वीचौकी गाउँपालिका,5305,4095,21263,9089,12174
डोटी,सायल गाउँपालिका,4311,3139,20125,9221,10904
डोटी,शिखर नगरपालिका,7089,5654,30294,13307,16987
कैलाली,बर्दगोरिया गाउँपालिका,8639,8162,37714,17882,19832
कैलाली,भजनी नगरपालिका,11143,10701,53795,25802,27993
कैलाली,चुरे गाउँपालिका,4272,4015,21437,10809,10628
कैलाली,धनगढी उपमहानगरपालिका,46670,39249,204788,102334,102454
कैलाली,गौरीगंगा नगरपालिका,13693,12984,64327,29730,34597
कैलाली,घोडाघोडी नगरपालिका,18636,17796,85982,40223,45759
कैलाली,गोदावरी नगरपालिका,21508,19356,99973,47873,52100
कैलाली,जानकी गाउँपालिका,11180,10657,49835,23202,26633
कैलाली,जोशीपुर गाउँपालिका,7775,7630,37167,17788,19379
कैलाली,कैलारी गाउँपालिका,10793,10458,50457,24485,25972
कैलाली,लम्कीचुहा नगरपालिका,20801,19367,90941,42795,48146
कैलाली,मोहन्याल गाउँपालिका,4450,4226,21285,10375,10910
कैलाली,टिकापुर नगरपालिका,20953,19091,90115,43354,46761
कञ्चनपुर,बेदकोट नगरपालिका,12780,11904,58250,27055,31195
कञ्चनपुर,बेलडाँडी गाउँपालिका,4727,4471,22041,9939,12102
कञ्चनपुर,बेलौरी नगरपालिका,11154,10296,53918,25526,28392
कञ्चनपुर,भीमदत्त नगरपालिका,27691,24715,123316,59400,63916
कञ्चनपुर,कृष्णपुर नगरपालिका,15272,14217,72501,34347,38154
कञ्चनपुर,लालझाडी गाउँपालिका,4822,4666,25271,12282,12989
कञ्चनपुर,दोधारा चाँदनी नगरपालिका,9657,8891,43486,19254,24232
कञ्चनपुर,पुनर्वास नगरपालिका,13676,12895,61628,28286,33342
कञ्चनपुर,शुक्लाफाँटा नगरपालिका,12120,11316,54379,24948,29431
डडेल्धुरा,आलिताल गाउँपालिका,3743,3421,18125,8773,9352
डडेल्धुरा,अजयमेरु गाउँपालिका,3479,2987,15243,7167,8076
डडेल्धुरा,अमरगढी नगरपालिका,6385,4752,24792,12515,12277
डडेल्धुरा,भागेश्वर गाउँपालिका,2812,2362,13112,6290,6822
डडेल्धुरा,गन्यापधुरा गाउँपालिका,3360,2788,13655,6158,7497
डडेल्धुरा,नवदुर्गा गाउँपालिका,4335,3634,18745,8194,10551
डडेल्धुरा,परशुराम नगरपालिका,7494,6559,35748,16833,18915
बैतडी,दशरथचन्द नगरपालिका,7339,6095,31786,15053,16733
बैतडी,डीलासैनी गाउँपालिका,4925,3930,23233,11347,11886
बैतडी,दोगडाकेदार गाउँपालिका,4774,3998,23619,10854,12765
बैतडी,मेलौली नगरपालिका,4626,3890,21000,9735,11265
बैतडी,पञ्चेश्वर गाउँपालिका,3617,2986,17780,8130,9650
बैतडी,पाटन नगरपालिका,6276,5195,28360,13415,14945
बैतडी,पुर्चौडी नगरपालिका,7236,6417,38666,18701,19965
बैतडी,शिवनाथ गाउँपालिका,3435,2919,18247,8489,9758
बैतडी,सिगास गाउँपालिका,4367,3652,23479,11153,12326
बैतडी,सुर्नया गाउँपालिका,3877,3206,18230,8549,9681
दार्चुला,अपिहिमाल गाउँपालिका,1363,1256,7023,3438,3585
दार्चुला,व्याँस गाउँपालिका,2361,2168,10205,4884,5321
दार्चुला,दुहुँ गाउँपालिका,2293,1906,9912,4580,5332
दार्चुला,लेकम गाउँपालिका,3045,2645,13638,6520,7118
दार्चुला,महाकाली नगरपालिका,6080,4596,24572,12072,12500
दार्चुला,मालिकार्जुन गाउँपालिका,3241,2993,15754,7631,8123
दार्चुला,मार्मा गाउँपालिका,3086,2704,15586,7551,8035
दार्चुला,नौगाड गाउँपालिका,3156,2920,16434,7988,8446
दार्चुला,शैल्यशिखर नगरपालिका,4561,4012,21932,10685,11247